{
    "level":
    {
        "name":"testLevel",
        "tileSet":"images/tileset1.png",
        "tileFPL":1,
        "tileSize":[64,64],
        "tileMap":[
            [1,1,1,1,1,1,1,1,1,1,1,1,1,1,1,1,1,1,1],
            [1,0,0,0,0,0,0,0,0,0,0,0,0,0,0,0,0,0,1],
            [1,0,0,0,0,0,0,0,0,0,0,0,0,0,0,0,0,0,1],
            [1,0,0,0,0,0,0,0,0,0,0,0,0,0,0,0,0,0,1],
            [1,0,0,1,0,0,0,0,0,0,0,0,0,0,0,0,0,0,1],
            [1,0,0,1,0,0,0,0,0,0,0,0,0,0,0,0,0,0,1],
            [1,0,0,1,0,0,0,0,0,0,0,0,0,0,0,0,0,0,1],
            [1,0,0,1,0,0,0,0,0,0,0,0,0,0,0,0,0,0,1],
            [1,0,0,0,0,0,0,0,1,1,1,1,1,1,1,1,0,0,1],
            [1,0,0,0,0,0,0,0,0,0,0,0,0,0,0,0,0,0,1],
            [1,0,0,0,0,0,0,0,0,0,0,0,0,0,0,0,0,0,1],
            [1,1,1,1,1,1,1,1,1,1,1,1,1,1,1,1,1,1,1],
        ]
    }
}